█████████████████████████
█     █                 █
█ ███ ███ █ █ █████████ █
█   █ █   █ █     █   █ █
███ █ █ ███████████ █ █ █
█   █     █         █   █
█ ███████ █ █████ █████ █
█       █ █ █   █     █ █
█████████ █ ███ █████ █ █
█ █   █   █   █     █ █ █
█ █ ███ █████ █████ █ █ █
█ █   █     █ █       █ █
█ ███ ███ █ █ █████████ █
█ █   █   █ █       █   █
█ █ ███ ███████████ █████
█ █   █ █   █     █     █
█ ███ █ █ █ █ █████████ █
█   █ █ █ █           █ █
███ █ █ █ ███ █████████ █
█   █ █   █   █       █ █
█ ███ ███ ███ █ █████ █ █
█   █ █   █   █   █ █   █
███ █ █ ███ █████ █ ███ █
█   █ █   █     █ █ █ █ █
█ █ █ ███ ███ ███ █ █ █ █
█ █     █ █   █   █ █   █
█ █████ ███ ███ ███ █ █ █
█X    █     █   █     █ █
█████████████████ ███████
