█████████████████████
█X█     █     █ █   █
█ █ █████████ █ █ █ █
█   █     █ █   █ █ █
█ █████ █ █ ███ ███ █
█       █   █ █   █ █
█ █████████ █ ███ █ █
█   █ █   █       █ █
███ █ █ ███████████ █
█   █     █     █   █
█ ███████ █ ███ █ █ █
█ █       █ █     █ █
█ █ █████████ █████ █
█ █       █   █   █ █
█ ███████ █ █████ █ █
█         █   █   █ █
█ ███████████ █ ███ █
█             █     █
███ █████████████ ███
█ █ █     █   █     █
█ █ █ █████ █ █████ █
█   █       █        
█████████████████████
