███████████████████████████████
█                     █   █   █
█ ███ ███████████████ █ █ █ █ █
█ █ █               █   █ █ █ █
█ █ █████ █ █████ ███████ █ █ █
█   █   █ █ █   █ █     █   █ █
███ █ ███ ███ █ █ █ ███ █████ █
█ █   █   █   █   █   █     █ █
█ ███ █ ███ ███████████████ █ █
█ █ █ █   █     █ █         █ █
█ █ █ ███ █████ █ █ █ ███████ █
█   █   █     █   █ █ █   █ █ █
███ ███ █ ███ █████ ███ █ █ █ █
█       █ █ █     █ █   █ █   █
█ ███████ █ ███████ █ ███ █████
█ █   █ █     █     █   █ █   █
█ █ █ █ █████ █ ███ ███ █ █ █ █
█   █      X█ █   █     █   █ █
█████████████ ███ ███████████ █
█     █   █     █ █       █   █
█ ███ █ █ █ ███ █ █ █ ███ █ █ █
█ █   █ █ █ █   █ █ █ █ █   █ █
█ █ ███ █ █ █████ █ █ █ █ ███ █
█ █   █ █ █ █     █ █   █ █   █
█ ███ █ █ █ █ █████ ███████ █ █
█ █     █     █   █ █     █ █ █
███ ███████████ █ █ █████ ███ █
█     █         █ █   █       █
███████████████████████████ ███